#######################
#                     #
# ##### # ### # ##### #
# ##### #     # ##### #
# ##### # # # # ##### #
#       # # # #       #
# ####### # # ####### #
# #                 # #
# # ####### ####### # #
#                     #
# ##### ####### ##### #
#       #######       #
# ### # ####### # ### #
# ### #         # ### #
# ### # ####### # ### #
#     # ####### #     #
# ##### ####### ##### #
#                     #
#######################
